{
  "cells": [
    [28, 28, 28, 28, 28, 28, 28, 28, 28, 28, 28, 28, 28, 28, 28],
    [28, 0, 0, 0, 0, 0, 0, 0, 0, 0, 0, 0, 0, 0, 28],
    [28, 0, 1, 0, 1, 0, 1, 0, 1, 0, 1, 0, 1, 0, 28],
    [28, 0, 1, 0, 1, 0, 1, 0, 1, 0, 1, 0, 1, 0, 28],
    [28, 0, 1, 0, 1, 0, 1, 2, 1, 0, 1, 0, 1, 0, 28],
    [28, 0, 1, 0, 1, 0, 13, 0, 13, 0, 1, 0, 1, 0, 28],
    [28, 0, 0, 0, 0, 8, 0, 0, 8, 0, 0, 0, 0, 0, 28],
    [28, 11, 0, 1, 1, 0, 0, 0, 0, 0, 1, 1, 0, 11, 28],
    [28, 0, 0, 0, 0, 0, 1, 1, 1, 0, 0, 0, 0, 0, 28],
    [28, 0, 1, 0, 1, 0, 1, 7, 1, 0, 1, 0, 1, 0, 28],
    [28, 0, 1, 0, 1, 0, 1, 0, 1, 0, 1, 0, 1, 0, 28],
    [28, 0, 1, 0, 1, 0, 0, 0, 0, 0, 1, 0, 1, 0, 28],
    [28, 0, 1, 0, 1, 0, 1, 1, 1, 0, 1, 0, 1, 0, 28],
    [28, 0, 0, 0, 0, 0, 1, 6, 1, 0, 0, 0, 0, 0, 28],
    [28, 28, 28, 28, 28, 28, 28, 28, 28, 28, 28, 28, 28, 28, 28]
  ]
}
